0010P0E0p0
10p01E1010
1X1010100K
1eP0pC0010
0110K01010
0000100000